111111111111111111111111111111111111111111111111
1000C0000000000000000000000000000000000000000001
1000000000000000000077777777000000000C0000000001
100000111000001111100000011111000000111111100001
100000101000000000010000000000100000000000100001
100000001000000000010000000000100007770001000001
100000001000C000111000E00001110000C0000010000001
100000001000000011100000000111000000000100C00001
100000001007777000010000000000100000001000000001
100000001000000000C10000000000000C10010000000001
100000111110001111100000011111000000100000000001
1000000000000000P0000077777700000000000000000001
111111111111111111111111111111111111111111111111