11111111111111111111111111111111111111
10000000700000000000000000700000000001
1P000000000100000100000000000000100001
1000000C000000000C00000000000000000001
100000000000000E0000007000011110000001
10000000000000000000000000000000000001
100000000700000000000000000C0000000001
10000000000000000000000000000000000001
1000000C000000070000000000000700000001
1070000000000C000000070000000000000001
10000000000100000000000000000000000001
11111111111111111111111111111111111111